17 19 178 178 178 178 178 178 178 10 11 11 11 11 11 11 11 12 178 179 
17 19 178 178 178 178 178 178 178 26 27 27 27 27 27 27 27 28 178 179 
17 19 178 178 178 178 178 178 178 26 27 27 27 27 27 27 27 28 178 179 
17 19 178 178 178 178 178 178 178 26 27 27 27 27 27 27 27 28 178 179 
17 19 178 178 178 178 178 178 178 26 27 27 27 27 27 27 27 28 178 179 
17 19 178 178 178 178 178 178 178 42 43 43 43 27 27 27 27 28 178 179 
17 19 178 178 178 178 178 178 178 178 178 178 178 26 27 27 27 28 178 179 
33 35 178 178 178 178 178 178 178 178 178 178 178 42 43 43 43 44 178 179 
177 178 178 178 178 178 178 178 178 178 178 178 178 178 178 178 178 178 178 179 
177 178 178 178 178 178 178 178 178 178 178 178 178 178 178 178 178 178 178 179 
177 178 178 178 178 178 178 178 178 178 178 178 178 178 178 178 178 178 178 179 
177 178 178 178 178 178 178 178 178 178 178 178 178 178 178 178 178 178 178 179 
193 194 194 194 194 194 194 194 194 194 194 194 194 194 194 194 194 194 194 195 
209 209 209 209 209 209 209 209 209 209 209 209 209 209 209 209 209 209 209 209 
164 164 164 164 164 164 164 164 164 164 164 164 164 164 164 164 164 164 164 164
